111111111111111
1P0000001100001
100001100000001
101100000011001
1000C1100000CE1
111111111111111