111111111111111
1P0000000000001
100000000000001
1000000000C0001
100000000000CE1
111111111111111