1111111111111111
1C00000000000001
100010010C1110C1
1000100100100C11
1E0011C100101111
110C1111C0000P11
1111111111111111
